1111111111111111111111111111111111111111
1E00001000100000100000001000000000110001
110010101010111C101110111011101110111101
10001000101C1010100010000010101000000001
1010111011111010111111101010111011111101
10101010000C00000010C0001010001010010001
1111101111110111101011111010111111110101
101C10100010000010100000100C001010000101
1010101010111011101110101111111011111101
1000001010100000100000101010001000100001
1010101011111110111011111010111110111101
10101000C00010000010000C00000010000P01C1
10101010000C00000010C0001010001010010001
1111101111110111101011111010111111110101
101C10100010000010100000100C001010000101
1010101010111011101110101111111011111101
1000001010100000100000101010001000100001
1010101011111110111011111010111110111101
10101000C00010000010000C00000010000001C1
1010101011111011101010101110111011111111
1C10101000000010000010100010000010000001
1111111111111111111111111111111111111111