111111111111111111
10100000E000001001
10000000C00001C101
100000110000100001
100001C00000000001
100001010000P00001
100001110000000001
111111111111111111