1111111111v1111111111111
10000000000v000000000001
10000000000v000000000001
11111111111f111111111111