1111111111111111111111
10100000000E0000100001
100000000C000001C10001
1000100110000010000001
1000001C00000000000001
10000010100000P0000001
1000001110000000000001
1111111111111111111111