1111111111111111111111
1000000C0000000C000001
10000C00000E000P000001
1000000000000000000001
1000000110000000000001
1000001C01000000C00001
10000C1010000000000001
1000001110000000000001
1111111111111111111111