11111111
1P000001
100C00E1
11111111