111111111111111111111111111
1ECCCCCCCCCCCCCCCCCCCCCCCC1
1CCCCCC11CCCCCC11111CCCCCC1
1CCCCC101CCCCCCCCCC1CCCCCC1
1CCCC1001CCCCCC11111CCCCCC1
1CCC10001CCCCCC1CCCCCCCCCC1
1CCC1111111CCCC1CCCCCCCCCC1
1CCCCCCC1CCCCCC11111CCCCCC1
1CCCCCCCCCCCCCCCCCCCCCCCCP1
111111111111111111111111111