11111111111111111111111111
1ECCCCCCCCCCCCCCCCCCCCCCC1
1CCCCCC11CCCCCC11111CCCCC1
1CCCCC101CCCCCCCCCC1CCCCC1
1CCCC1001CCCCCC11111CCCCC1
1CCC10001CCCCCC1CCCCCCCCC1
1CCC1111111CCCC1CCCCCCCCC1
1CCCCCCC1CCCCCC11111CCCCC1
1CCCCCCCCCCCCCCCCCCCCCCCP1
11111111111111111111111111