11111111111111111111111111111111111111111
1E000010001000001000000010000000001100011
110010101010111C1011101110111011101111011
10001000101C10101000100000101010000000011
10101110111110101111111010101110111111011
10101010000C00000010C00010100010100100011
11111011111101111010111110101111111101011
101C10100010000010100000100C0010100001011
10101010101110111011101011111110111111011
10000010101000001000001010100010001000011
10101010111111101110111110101111101111011
10101000C00010000010000C00000010000P01C11
10101010000C00000010C00010100010100100011
11111011111101111010111110101111111101011
101C10100010000010100000100C0010100001011
10101010101110111011101011111110111111011
10000010101000001000001010100010001000011
10101010111111101110111110101111101111011
10101000C00010000010000C00000010000001C11
10101010111110111010101011101110111111111
1C101010000000100000101000100000100000011
11111111111111111111111111111111111111111
11111111111111111111111111111111111111111