11111111
1P010001
101E10E1
100100E1
11111111