11111111111111111111111111111
1ECCCCCCCCCCCCCCCCCCCCCCCCCC1
1CCCCCC11CCCCCC11111CCCCCCCC1
1CCCCC101CCCCCCCCCC1CCCCCCCC1
1CCCC1001CCCCCC11111CCCCCCCC1
1CCC10001CCCCCC1CCCCCCCCCCCC1
1CCC1111111CCCC1CCCCCCCCCCCC1
1CCCCCCC1CCCCCC11111CCCCCCCC1
1CCCCCCC1CCCCCC11111CCCCCCCC1
1CCCCCCC1CCCCCC11111CCCCCCCC1
1CCCCCCC1CCCCCC11111CCCCCCCC1
1CCCCCCC1CCCCCC11111CCCCCCCC1
1CCCCCCC1CCCCCC11111CCCCCCCC1
1CCCCCCC1CCCCCC11111CCCCCCCC1
1CCCCCCC1CCCCCC11111CCCCCCCC1
1CCCCCCC1CCCCCC11111CCCCCCCC1
1CCCCCCC1CCCCCC11111CCCCCCCC1
1CCCCCCC1CCCCCC11111CCCCCCCC1
1CCCCCCC1CCCCCC11111CCCCCCCC1
1CCCCCCC1CCCCCC11111CCCCCCCC1
1CCCCCCC1CCCCCC11111CCCCCCCC1
1CCCCCCC1CCCCCC11111CCCCCCCC1
1CCCCCCC1CCCCCC11111CCCCCCCC1
1CCCCCCC1CCCCCC11111CCCCCCCC1
1CCCCCCC1CCCCCC11111CCCCCCCC1
1CCCCCCC1CCCCCC11111CCCCCCCC1
1CCCCCCC1CCCCCC11111CCCCCCCC1
1CCCCCCC1CCCCCC11111CCCCCCCC1
1CCCCCCC1CCCCCC11111CCCCCCCC1
1CCCCCCC1CCCCCC11111CCCCCCCC1
1CCCCCCC1CCCCCC11111CCCCCCCC1
1CCCCCCC1CCCCCC11111CCCCCCCC1
1CCCCCCC1CCCCCC11111CCCCCCCC1
1CCCCCCC1CCCCCC11111CCCCCCCC1
1CCCCCCC1CCCCCC11111CCCCCCCC1
1CCCCCCC1CCCCCC11111CCCCCCCC1
1CCCCCCC1CCCCCC11111CCCCCCCC1
1CCCCCCC1CCCCCC11111CCCCCCCC1
1CCCCCCC1CCCCCC11111CCCCCCCC1
1CCCCCCC1CCCCCC11111CCCCCCCC1
1CCCCCCC1CCCCCC11111CCCCCCCC1
1CCCCCCC1CCCCCC11111CCCCCCCC1
1CCCCCCC1CCCCCC11111CCCCCCCC1
1CCCCCCC1CCCCCC11111CCCCCCCC1
1CCCCCCC1CCCCCC11111CCCCCCCC1
1CCCCCCC1CCCCCC11111CCCCCCCC1
1CCCCCCC1CCCCCC11111CCCCCCCC1
1CCCCCCC1CCCCCC11111CCCCCCCC1
1CCCCCCC1CCCCCC11111CCCCCCCC1
1CCCCCCC1CCCCCC11111CCCCCCCC1
1CCCCCCC1CCCCCC11111CCCCCCCC1
1CCCCCCC1CCCCCC11111CCCCCCCC1
1CCCCCCC1CCCCCC11111CCCCCCCC1
1CCCCCCC1CCCCCC11111CCCCCCCC1
1CCCCCCC1CCCCCC11111CCCCCCCC1
1CCCCCCC1CCCCCC11111CCCCCCCC1
1CCCCCCC1CCCCCC11111CCCCCCCC1
1CCCCCCC1CCCCCC11111CCCCCCCC1
1CCCCCCC1CCCCCC11111CCCCCCCC1
1CCCCCCC1CCCCCC11111CCCCCCCC1
1CCCCCCC1CCCCCC11111CCCCCCCC1
1CCCCCCC1CCCCCC11111CCCCCCCC1
1CCCCCCC1CCCCCC11111CCCCCCCC1
1CCCCCCC1CCCCCC11111CCCCCCCC1
1CCCCCCC1CCCCCC11111CCCCCCCC1
1CCCCCCC1CCCCCC11111CCCCCCCC1
1CCCCCCC1CCCCCC11111CCCCCCCC1
1CCCCCCC1CCCCCC11111CCCCCCCC1
1CCCCCCC1CCCCCC11111CCCCCCCC1
1CCCCCCC1CCCCCC11111CCCCCCCC1
1CCCCCCC1CCCCCC11111CCCCCCCC1
1CCCCCCC1CCCCCC11111CCCCCCCC1
1CCCCCCC1CCCCCC11111CCCCCCCC1
1CCCCCCC1CCCCCC11111CCCCCCCC1
1CCCCCCC1CCCCCC11111CCCCCCCC1
1CCCCCCC1CCCCCC11111CCCCCCCC1
1CCCCCCC1CCCCCC11111CCCCCCCC1
1CCCCCCC1CCCCCC11111CCCCCCCC1
1CCCCCCC1CCCCCC11111CCCCCCCC1
1CCCCCCC1CCCCCC11111CCCCCCCC1
1CCCCCCC1CCCCCC11111CCCCCCCC1
1CCCCCCC1CCCCCC11111CCCCCCCC1
1CCCCCCC1CCCCCC11111CCCCCCCC1
1CCCCCCC1CCCCCC11111CCCCCCCC1
1CCCCCCC1CCCCCC11111CCCCCCCC1
1CCCCCCC1CCCCCC11111CCCCCCCC1
1CCCCCCC1CCCCCC11111CCCCCCCC1
1CCCCCCC1CCCCCC11111CCCCCCCC1
1CCCCCCC1CCCCCC11111CCCCCCCC1
1CCCCCCC1CCCCCC11111CCCCCCCC1
1CCCCCCC1CCCCCC11111CCCCCCCC1
1CCCCCCC1CCCCCC11111CCCCCCCC1
1CCCCCCC1CCCCCC11111CCCCCCCC1
1CCCCCCC1CCCCCC11111CCCCCCCC1
1CCCCCCC1CCCCCC11111CCCCCCCC1
1CCCCCCC1CCCCCC11111CCCCCCCC1
1CCCCCCC1CCCCCC11111CCCCCCCC1
1CCCCCCC1CCCCCC11111CCCCCCCC1
1CCCCCCC1CCCCCC11111CCCCCCCC1
1CCCCCCC1CCCCCC11111CCCCCCCC1
1CCCCCCC1CCCCCC11111CCCCCCCC1
1CCCCCCC1CCCCCC11111CCCCCCCC1
1CCCCCCC1CCCCCC11111CCCCCCCC1
1CCCCCCC1CCCCCC11111CCCCCCCC1
1CCCCCCC1CCCCCC11111CCCCCCCC1
1CCCCCCC1CCCCCC11111CCCCCCCC1
1CCCCCCC1CCCCCC11111CCCCCCCC1
1CCCCCCC1CCCCCC11111CCCCCCCC1
1CCCCCCC1CCCCCC11111CCCCCCCC1
1CCCCCCC1CCCCCC11111CCCCCCCC1
1CCCCCCC1CCCCCC11111CCCCCCCC1
1CCCCCCC1CCCCCC11111CCCCCCCC1
1CCCCCCC1CCCCCC11111CCCCCCCC1
1CCCCCCC1CCCCCC11111CCCCCCCC1
1CCCCCCC1CCCCCC11111CCCCCCCC1
1CCCCCCC1CCCCCC11111CCCCCCCC1
1CCCCCCC1CCCCCC11111CCCCCCCC1
1CCCCCCC1CCCCCC11111CCCCCCCC1
1CCCCCCC1CCCCCC11111CCCCCCCC1
1CCCCCCC1CCCCCC11111CCCCCCCC1
1CCCCCCC1CCCCCC11111CCCCCCCC1
1CCCCCCC1CCCCCC11111CCCCCCCC1
1CCCCCCC1CCCCCC11111CCCCCCCC1
1CCCCCCC1CCCCCC11111CCCCCCCC1
1CCCCCCC1CCCCCC11111CCCCCCCC1
1CCCCCCC1CCCCCC11111CCCCCCCC1
1CCCCCCCCCCCCCCCCCCCCCCCCCCP1
11111111111111111111111111111